NO sample.c
SO fileso
WE filewe
EA fileea
F 12.12.12
C 13.13.12
11111111111111111
