NO sample.c
C  13.13.12

SO      fileso
WE  filewe



F   12.12.12
11111111111111111
