SO            textures/SO.texture
NO textures/NO.texture
WE 'textures/WE.texture'
EA "textures/EA.texture"
F [123,123,123]

C [3,1,256]
11111111111111111
