NO sample.c
C 13.13.12

SO fileso
WE  filewe

EA a

F   12.12.12
C 1.23.2
11111111111111111
