SO textures/map3/SO.xpm
WE textures/map3/WE.xpm
NO textures/map3/NO.xpm
EA textures/map3/EA.xpm
C 205,249,255
F 157,157,157
11111111111
100010001
100000001
100000001
100010001
100000001 1
100000001 1
1 000N00011
111111111111