1111111111111111111111111
1000000100000001000001001
1P00000100011001010001001
1000000100011001010000001
1000000000011000011111111
1111111111111111111111111
