SO textures/SO.xpm
WE textures/WE.xpm
NO textures/NO.xpm
EA textures/EA.xpm
F 13,131,13
C 131,1,131
111111111111111111111111111
100000010000000100000100111
1N0000010001100101000100111
100000010001100101000000111
100000000001100001111111111
111111111111111001111111111
100001000000010000000111111
111100000000000000000001111
111111111111111111111111111